#############
###O.#H#..###
###..#.#..###
###..#X#..###
###.......###
 #####.#####
 #####.#####
 #####.#####
 #####O#####
 #####.#####
 #####.#####
 #####.#####
 #####.#####
 #####.#####
 #####@#####
 ###########
 
